#module 0 size: 18 bs: 6.28944e-101
7 10 13 17 18 22 28 31 33 37 38 41 44 45 47 50 51 56 
#module 1 size: 73 bs: 2.97751e-101
201 203 204 205 206 208 210 211 212 213 214 215 216 217 218 219 222 223 224 225 226 227 229 230 232 234 237 239 240 242 243 244 245 247 248 249 252 253 254 256 259 262 263 264 265 266 267 270 272 274 275 276 277 278 279 281 282 284 285 286 287 288 289 290 291 293 294 295 296 297 298 299 300 
#module 2 size: 28 bs: 7.01661e-14
1 2 3 4 9 15 21 23 27 30 34 43 46 48 49 53 60 63 68 70 72 73 74 78 79 81 83 93 
#module 3 size: 35 bs: 0.000478335
5 11 16 25 32 35 36 40 57 61 62 64 69 75 76 77 80 82 84 85 86 87 88 89 90 91 92 93 94 95 96 97 98 99 100 
#module 4 size: 15 bs: 9.9698e-14
6 19 20 29 42 52 54 55 58 59 65 66 67 71 97 
#module 5 size: 12 bs: 0.0025921
124 135 145 154 161 167 179 184 185 187 188 200 
#module 6 size: 40 bs: 0.00881459
102 111 112 117 119 125 126 128 132 133 134 137 138 150 152 153 157 158 162 168 169 170 171 172 174 177 180 181 186 189 190 191 192 193 194 195 196 197 198 199 
#module 7 size: 26 bs: 2.16409e-07
103 106 114 116 121 123 136 139 140 141 142 143 144 146 147 148 149 151 155 159 160 166 171 175 176 183 
#module 0 size: 18 bs: 1.57473e-101
7 10 13 17 18 22 28 31 33 37 38 41 44 45 47 50 51 56 
#module 1 size: 28 bs: 7.01661e-14
1 2 3 4 9 15 21 23 27 30 34 43 46 48 49 53 60 63 68 70 72 73 74 78 79 81 83 93 
#module 2 size: 35 bs: 0.000478335
5 11 16 25 32 35 36 40 57 61 62 64 69 75 76 77 80 82 84 85 86 87 88 89 90 91 92 93 94 95 96 97 98 99 100 
#module 3 size: 15 bs: 9.9698e-14
6 19 20 29 42 52 54 55 58 59 65 66 67 71 97 
#module 4 size: 52 bs: 0.0025921
201 203 204 208 210 212 213 216 217 218 224 225 226 227 229 230 232 234 237 239 242 244 245 247 248 249 253 254 256 259 262 263 264 265 266 267 270 272 274 276 277 282 284 286 288 289 291 294 295 296 297 299 
#module 5 size: 12 bs: 4.67312e-09
214 215 252 275 278 279 281 287 290 293 298 300 
#module 6 size: 13 bs: 3.00879e-05
124 135 145 154 161 167 179 182 184 185 187 188 200 
#module 7 size: 47 bs: 0.0109653
102 107 111 112 117 119 120 125 126 127 128 130 132 133 134 137 138 150 152 153 156 157 158 162 165 168 169 170 171 172 174 177 180 181 186 189 190 191 192 193 194 195 196 197 198 199 200 
#module 8 size: 26 bs: 9.07711e-09
103 106 114 116 121 123 136 139 140 141 142 143 144 146 147 148 149 151 155 159 160 166 171 175 176 183 
#module 0 size: 18 bs: 7.84346e-101
7 10 13 17 18 22 28 31 33 37 38 41 44 45 47 50 51 56 
#module 1 size: 28 bs: 7.01661e-14
1 2 3 4 9 15 21 23 27 30 34 43 46 48 49 53 60 63 68 70 72 73 74 78 79 81 83 93 
#module 2 size: 35 bs: 0.000478335
5 11 16 25 32 35 36 40 57 61 62 64 69 75 76 77 80 82 84 85 86 87 88 89 90 91 92 93 94 95 96 97 98 99 100 
#module 3 size: 15 bs: 9.9698e-14
6 19 20 29 42 52 54 55 58 59 65 66 67 71 97 
#module 4 size: 48 bs: 0.0025921
201 203 206 208 211 213 216 217 219 223 226 230 232 234 237 239 242 244 245 247 248 249 253 254 256 259 262 263 264 265 266 267 270 272 274 276 277 282 284 285 286 288 289 291 294 295 296 297 
#module 5 size: 12 bs: 1.85504e-09
214 215 252 275 278 279 281 287 290 293 298 300 
#module 6 size: 13 bs: 0.000104537
124 135 145 154 161 167 179 182 184 185 187 188 200 
#module 7 size: 47 bs: 0.00988882
102 107 111 112 117 119 120 125 126 127 128 130 132 133 134 137 138 150 152 153 156 157 158 162 165 168 169 170 171 172 174 177 180 181 186 189 190 191 192 193 194 195 196 197 198 199 200 
#module 8 size: 26 bs: 0.0109653
103 106 114 116 121 123 136 139 140 141 142 143 144 146 147 148 149 151 155 159 160 166 171 175 176 183 
#module 0 size: 18 bs: 1.54685e-101
7 10 13 17 18 22 28 31 33 37 38 41 44 45 47 50 51 56 
#module 1 size: 28 bs: 7.01661e-14
1 2 3 4 9 15 21 23 27 30 34 43 46 48 49 53 60 63 68 70 72 73 74 78 79 81 83 93 
#module 2 size: 35 bs: 0.000478335
5 11 16 25 32 35 36 40 57 61 62 64 69 75 76 77 80 82 84 85 86 87 88 89 90 91 92 93 94 95 96 97 98 99 100 
#module 3 size: 15 bs: 9.9698e-14
6 19 20 29 42 52 54 55 58 59 65 66 67 71 97 
#module 4 size: 52 bs: 0.0025921
203 206 208 211 212 216 217 218 219 222 223 224 225 226 227 229 230 234 237 239 242 243 245 247 248 249 253 254 256 259 262 263 264 265 266 267 270 272 274 276 277 282 284 285 286 288 289 291 294 295 296 297 
#module 5 size: 12 bs: 4.86454e-08
214 215 252 275 278 279 281 287 290 293 298 300 
#module 6 size: 13 bs: 1.29257e-07
124 135 145 154 161 167 179 182 184 185 187 188 200 
#module 7 size: 47 bs: 0.00779992
102 107 111 112 117 119 120 125 126 127 128 130 132 133 134 137 138 150 152 153 156 157 158 162 165 168 169 170 171 172 174 177 180 181 186 189 190 191 192 193 194 195 196 197 198 199 200 
#module 8 size: 26 bs: 0.0109653
103 106 114 116 121 123 136 139 140 141 142 143 144 146 147 148 149 151 155 159 160 166 171 175 176 183 
#module 0 size: 18 bs: 3.13913e-102
7 10 13 17 18 22 28 31 33 37 38 41 44 45 47 50 51 56 
#module 1 size: 28 bs: 7.01661e-14
1 2 3 4 9 15 21 23 27 30 34 43 46 48 49 53 60 63 68 70 72 73 74 78 79 81 83 93 
#module 2 size: 35 bs: 0.000478335
5 11 16 25 32 35 36 40 57 61 62 64 69 75 76 77 80 82 84 85 86 87 88 89 90 91 92 93 94 95 96 97 98 99 100 
#module 3 size: 15 bs: 9.9698e-14
6 19 20 29 42 52 54 55 58 59 65 66 67 71 97 
#module 4 size: 51 bs: 0.0025921
201 204 206 208 210 211 213 216 218 219 222 223 224 227 229 230 234 237 242 243 244 245 247 248 249 253 254 256 259 263 264 265 266 267 270 272 274 276 277 282 284 285 286 288 289 291 294 295 296 297 299 
#module 5 size: 12 bs: 8.37837e-08
214 215 252 275 278 279 281 287 290 293 298 300 
#module 6 size: 12 bs: 0.00988883
124 135 145 154 161 167 179 184 185 187 188 200 
#module 7 size: 39 bs: 3.91215e-07
102 111 112 117 119 125 126 128 132 133 134 137 138 150 153 157 158 162 168 169 170 171 172 174 177 180 181 186 189 190 191 192 193 194 195 196 197 198 199 
#module 8 size: 26 bs: 2.3885e-05
103 106 114 116 121 123 136 139 140 141 142 143 144 146 147 148 149 151 155 159 160 166 171 175 176 183 
#module 0 size: 18 bs: 3.00188e-102
7 10 13 17 18 22 28 31 33 37 38 41 44 45 47 50 51 56 
#module 1 size: 28 bs: 7.01661e-14
1 2 3 4 9 15 21 23 27 30 34 43 46 48 49 53 60 63 68 70 72 73 74 78 79 81 83 93 
#module 2 size: 35 bs: 0.000478335
5 11 16 25 32 35 36 40 57 61 62 64 69 75 76 77 80 82 84 85 86 87 88 89 90 91 92 93 94 95 96 97 98 99 100 
#module 3 size: 15 bs: 9.9698e-14
6 19 20 29 42 52 54 55 58 59 65 66 67 71 97 
#module 4 size: 53 bs: 0.0025921
201 203 204 206 208 210 212 213 216 217 218 219 224 225 226 227 229 230 232 234 237 242 243 244 245 247 248 249 253 254 256 259 263 264 265 266 267 270 272 274 276 277 282 284 286 288 289 291 294 295 296 297 299 
#module 5 size: 12 bs: 6.49591e-08
214 215 252 275 278 279 281 287 290 293 298 300 
#module 6 size: 12 bs: 1.48787e-06
124 135 145 154 161 167 179 184 185 187 188 200 
#module 7 size: 47 bs: 0.00988883
102 107 111 112 117 119 120 125 126 127 128 130 132 133 134 137 138 150 152 153 156 157 158 162 165 168 169 170 171 172 174 177 180 181 186 189 190 191 192 193 194 195 196 197 198 199 200 
#module 8 size: 26 bs: 0.0088146
103 106 114 116 121 123 136 139 140 141 142 143 144 146 147 148 149 151 155 159 160 166 171 175 176 183 
#module 0 size: 18 bs: 5.03724e-101
7 10 13 17 18 22 28 31 33 37 38 41 44 45 47 50 51 56 
#module 1 size: 28 bs: 7.01661e-14
1 2 3 4 9 15 21 23 27 30 34 43 46 48 49 53 60 63 68 70 72 73 74 78 79 81 83 93 
#module 2 size: 35 bs: 0.000478335
5 11 16 25 32 35 36 40 57 61 62 64 69 75 76 77 80 82 84 85 86 87 88 89 90 91 92 93 94 95 96 97 98 99 100 
#module 3 size: 15 bs: 9.9698e-14
6 19 20 29 42 52 54 55 58 59 65 66 67 71 97 
#module 4 size: 13 bs: 1.32207e-05
124 135 145 154 161 167 179 182 184 185 187 188 200 
#module 5 size: 40 bs: 0.00955755
102 107 112 117 119 125 128 130 132 133 137 150 152 153 156 157 158 162 165 168 169 170 171 172 174 177 180 181 186 189 190 191 192 193 194 195 196 197 198 199 
#module 6 size: 26 bs: 1.12771e-06
103 106 114 116 121 123 136 139 140 141 142 143 144 146 147 148 149 151 155 159 160 166 171 175 176 183 
#module 7 size: 100 bs: 4.34234e-101
201 202 203 204 205 206 207 208 209 210 211 212 213 214 215 216 217 218 219 220 221 222 223 224 225 226 227 228 229 230 231 232 233 234 235 236 237 238 239 240 241 242 243 244 245 246 247 248 249 250 251 252 253 254 255 256 257 258 259 260 261 262 263 264 265 266 267 268 269 270 271 272 273 274 275 276 277 278 279 280 281 282 283 284 285 286 287 288 289 290 291 292 293 294 295 296 297 298 299 300 
#module 0 size: 18 bs: 3.41816e-101
7 10 13 17 18 22 28 31 33 37 38 41 44 45 47 50 51 56 
#module 1 size: 28 bs: 7.01661e-14
1 2 3 4 9 15 21 23 27 30 34 43 46 48 49 53 60 63 68 70 72 73 74 78 79 81 83 93 
#module 2 size: 35 bs: 0.000478335
5 11 16 25 32 35 36 40 57 61 62 64 69 75 76 77 80 82 84 85 86 87 88 89 90 91 92 93 94 95 96 97 98 99 100 
#module 3 size: 15 bs: 9.9698e-14
6 19 20 29 42 52 54 55 58 59 65 66 67 71 97 
#module 4 size: 54 bs: 0.0025921
201 203 204 208 210 211 212 213 216 217 218 219 222 223 224 225 227 229 230 234 237 242 243 244 245 247 248 249 253 254 256 259 263 264 265 266 267 270 272 274 276 277 282 284 285 286 288 289 291 294 295 296 297 299 
#module 5 size: 13 bs: 1.00071e-07
214 215 252 268 275 278 279 281 287 290 293 298 300 
#module 6 size: 13 bs: 4.23178e-07
124 135 145 154 161 167 179 182 184 185 187 188 200 
#module 7 size: 37 bs: 6.67477e-07
102 107 112 117 119 125 128 130 133 137 150 152 153 156 157 162 165 168 169 171 172 174 177 180 181 186 189 190 191 192 193 194 195 196 197 198 199 
#module 8 size: 26 bs: 1.71709e-05
103 106 114 116 121 123 136 139 140 141 142 143 144 146 147 148 149 151 155 159 160 166 171 175 176 183 
#module 0 size: 18 bs: 4.81572e-101
7 10 13 17 18 22 28 31 33 37 38 41 44 45 47 50 51 56 
#module 1 size: 28 bs: 7.01661e-14
1 2 3 4 9 15 21 23 27 30 34 43 46 48 49 53 60 63 68 70 72 73 74 78 79 81 83 93 
#module 2 size: 35 bs: 0.000478335
5 11 16 25 32 35 36 40 57 61 62 64 69 75 76 77 80 82 84 85 86 87 88 89 90 91 92 93 94 95 96 97 98 99 100 
#module 3 size: 15 bs: 9.9698e-14
6 19 20 29 42 52 54 55 58 59 65 66 67 71 97 
#module 4 size: 52 bs: 0.0025921
203 206 208 210 211 212 216 217 219 222 223 224 225 226 229 230 232 237 239 242 243 244 245 247 248 249 253 254 256 259 262 263 264 265 266 267 270 272 274 276 277 282 284 285 286 288 289 291 294 295 296 297 
#module 5 size: 13 bs: 2.41617e-09
214 215 252 268 275 278 279 281 287 290 293 298 300 
#module 6 size: 13 bs: 1.74557e-06
124 135 145 154 161 167 179 182 184 185 187 188 200 
#module 7 size: 47 bs: 0.00955756
102 107 111 112 117 119 120 125 126 127 128 130 132 133 134 137 138 150 152 153 156 157 158 162 165 168 169 170 171 172 174 177 180 181 186 189 190 191 192 193 194 195 196 197 198 199 200 
#module 8 size: 26 bs: 5.8617e-07
103 106 114 116 121 123 136 139 140 141 142 143 144 146 147 148 149 151 155 159 160 166 171 175 176 183 
#module 0 size: 18 bs: 3.99706e-101
7 10 13 17 18 22 28 31 33 37 38 41 44 45 47 50 51 56 
#module 1 size: 28 bs: 7.01661e-14
1 2 3 4 9 15 21 23 27 30 34 43 46 48 49 53 60 63 68 70 72 73 74 78 79 81 83 93 
#module 2 size: 35 bs: 0.000478335
5 11 16 25 32 35 36 40 57 61 62 64 69 75 76 77 80 82 84 85 86 87 88 89 90 91 92 93 94 95 96 97 98 99 100 
#module 3 size: 15 bs: 9.9698e-14
6 19 20 29 42 52 54 55 58 59 65 66 67 71 97 
#module 4 size: 13 bs: 0.00988882
124 135 145 154 161 167 179 182 184 185 187 188 200 
#module 5 size: 47 bs: 0.0109653
102 107 111 112 117 119 120 125 126 127 128 130 132 133 134 137 138 150 152 153 156 157 158 162 165 168 169 170 171 172 174 177 180 181 186 189 190 191 192 193 194 195 196 197 198 199 200 
#module 6 size: 26 bs: 9.07712e-09
103 106 114 116 121 123 136 139 140 141 142 143 144 146 147 148 149 151 155 159 160 166 171 175 176 183 
#module 7 size: 100 bs: 4.93944e-102
201 202 203 204 205 206 207 208 209 210 211 212 213 214 215 216 217 218 219 220 221 222 223 224 225 226 227 228 229 230 231 232 233 234 235 236 237 238 239 240 241 242 243 244 245 246 247 248 249 250 251 252 253 254 255 256 257 258 259 260 261 262 263 264 265 266 267 268 269 270 271 272 273 274 275 276 277 278 279 280 281 282 283 284 285 286 287 288 289 290 291 292 293 294 295 296 297 298 299 300 
